00000000000000000000000000000
00000000000000000000000000000
00000000000000000000000000000
00000000000000000000000000000
00000000000000000000000000000
00000000000000000000000000000
00000000000000000000000000000
00000000000000000000000000000
00000000000000000000000000000
00000000000000000000000000000
00000000000000000000000000000
00000000000000000000000000000
00000000000000000000000000000
00000000000000000000000000000
00000000000000000000000000000
00000000000000000000000000000
00000000000000000000000000000
00000000000000000000000122210
00000000000000000000111111111
00000000000000000000000111111
00000000000000000000000000000
00000000111000000000000000000
00000001111110000000000044000
00000011100000001100000000000
00003311110000000110000000000
00011111114000011110000000000
00111111111111111111000000000
44111111111111111111100000001
11111111111111111111111222211